1.1
9 9
0 0 0 0 0 0 0 0 0 
0 1 1 1 1 1 1 1 0 
0 1 3 1 1 1 1 1 0 
0 1 1 1 1 1 1 1 0 
0 0 0 1 4 1 Sub 1 0 
0 0 0 1 1 1 1 1 0 
0 0 0 1 2 1 5 1 0 
0 0 0 1 1 1 1 1 0 
0 0 0 1 1 1 1 1 0 
0 0 0 0 0 0 0 0 0 
0 1 1 1 1 1 1 1 0 
0 1 1 1 1 1 1 1 0 
0 1 1 1 1 1 1 1 0 
0 0 0 1 1 1 1 1 0 
0 0 0 1 1 1 1 1 0 
0 0 0 1 2 1 5 1 0 
0 0 0 1 1 1 1 1 0 
0 0 0 1 1 1 1 1 0 
Sub
5 5
0 0 1 0 0 
0 0 1 0 0 
1 1 1 0 0 
0 0 0 0 0 
0 0 0 0 0 
0 0 1 0 0 
0 0 1 0 0 
1 1 1 0 0 
0 0 0 0 0 
0 0 0 0 0 
