1.3
9 9
0 0 0 0 0 0 0 0 0 
0 1 1 5 1 1 0 2 0
0 1 1 1 1 1 1 1 0
0 1 1 1 1 1 0 0 0
0 1 MAIN::Sub 1 3 1 1 1 0
0 1 1 1 1 1 1 1 0
0 1 4 1 1 1 1 1 0
0 1 1 1 0 0 1 1 0
0 0 0 0 0 0 0 0 0
0 0 0 0 0 0 0 0 0 
0 1 1 5 1 1 0 2 0
0 1 1 1 1 1 1 1 0
0 1 1 1 1 1 0 0 0
0 1 1 1 1 1 1 1 0
0 1 1 1 1 1 1 1 0
0 1 1 1 1 1 1 1 0
0 1 1 1 0 0 1 1 0
0 0 0 0 0 0 0 0 0
Sub
5 5 
0 0 1 0 0
0 0 1 0 0
1 1 1 0 0
0 0 0 0 0
0 0 0 0 0
0 0 1 0 0
0 0 1 0 0
1 1 1 0 0
0 0 0 0 0
0 0 0 0 0