1.4
9 9 
0 0 0 0 0 0 0 0 0
0 1 1 1 1 0 1 1 0
0 1 1 1 1 0 1 1 0
0 1 MAIN::1.4 1 3 0 1 1 0
0 1 2 1 1 0 1 1 0
0 1 2 1 1 0 1 1 0
0 1 5 4 1 1 1 1 1
0 1 1 1 1 0 0 0 0
0 0 0 0 1 0 0 0 0
0 0 0 0 0 0 0 0 0
0 1 1 1 1 0 1 1 0
0 1 1 1 1 0 1 1 0
0 1 1 1 1 0 1 1 0
0 1 2 1 1 0 1 1 0
0 1 2 1 1 0 1 1 0
0 1 5 1 1 1 1 1 1
0 1 1 1 1 0 0 0 0
0 0 0 0 1 0 0 0 0