2.2
9 9
0 0 0 0 0 0 0 0 0
0 0 0 0 0 0 0 0 0
0 2.2 3 Sub_Map_0 Sub_Map_1 3 3 1 3
0 0 1 0 0 0 1 1 0
0 0 1 1 1 1 1 1 0
0 0 1 1 4 1 1 1 0
0 0 1 1 1 1 1 1 0
0 0 0 0 0 0 0 0 0
0 0 0 0 0 0 0 0 0
0 0 0 0 0 0 0 0 0
0 0 0 0 0 0 0 0 0
0 2.2 1 1_1 1 1 1 1
0 0 1 0 0 0 1 1 0
0 0 1 1 1 1 1 1 0
0 0 1 1 1 1 1 1 0
0 0 1 1 1 1 1 1 0
0 0 0 0 0 0 0 0 0
0 0 0 0 0 0 0 0 0
Sub_Map_0
3 3
0 0 0
0 2 0
0 3 0
0 0 0
0 2 0
0 1 0
Sub_Map_1
3 3
0 0 0
0 5 0
0 1 0
0 0 0
0 5 0
0 1 0