2.3
9 9
0 0 0 0 0 0 0 0 0
0 0 0 0 0 1 1 1 0
0 0 0 1 3 1 4 1 0
0 5 2 1 0 1 1 1 0
0 1 1 1 0 1 1 1 0
0 1 1 1 0 1 1 1 0
0 0 Sub_Map_0 1 0 1 Sub_Map_1 0 0
0 0 0 0 0 0 0 0 0
0 0 0 0 0 0 0 0 0
0 0 0 0 0 0 0 0 0
0 0 0 0 0 1 1 1 0
0 0 0 1 1 1 1 1 0
0 5 2 1 0 1 1 1 0
0 1 1 1 0 1 1 1 0
0 1 1 1 0 1 1 1 0
0 0 1 1 0 1 1 0 0
0 0 0 0 0 0 0 0 0
0 0 0 0 0 0 0 0 0
Sub_Map_0
3 3
0 1 0
0 1 1
0 0 0
0 1 0
0 1 1
0 0 0
Sub_Map_1
3 3
0 1 0
0 1 1
0 0 0
0 1 0
0 1 1
0 0 0