2.3
9 9
0 0 0 0 0 0 0 0 0
0 1 1 1 1 1 0 0 0
0 1 1 1 1 2 1 5 0
0 1 1 1 1 1 0 0 0
0 1 1 MAIN::2.3 1 1 0 0 4
0 1 1 1 1 1 0 0 0
0 1 1 1 1 1 0 0 0
0 2.3 1 0 0 0 0 0 0
0 0 0 0 0 0 0 0 0
0 0 0 0 0 0 0 0 0
0 1 1 1 1 1 0 0 0
0 1 1 1 1 2 1 5 0
0 1 1 1 1 1 0 0 0
0 1 1 1 1 1 0 0 1
0 1 1 1 1 1 0 0 0
0 1 1 1 1 1 0 0 0
0 1 1 0 0 0 0 0 0 
0 0 0 0 0 0 0 0 0