2.4
9 9
0 0 0 0 1 0 0 0 0
0 0 0 0 1 0 1 0 0
0 1 1 3 1 MAIN::2.4 1 1 0
0 1 1 1 1 1 1 1 0
0 1 1 1 1 1 1 1 0
0 1 1 2 5 2 1 1 0
0 1 1 1 4 1 1 1 0
0 0 0 0 0 0 0 0 0
0 0 0 0 0 0 0 0 0
0 0 0 0 1 0 0 0 0
0 0 0 0 1 0 1 0 0
0 1 1 1 1 1 1 1 0
0 1 1 1 1 1 1 1 0
0 1 1 1 1 1 1 1 0
0 1 1 2 5 2 1 1 0
0 1 1 1 1 1 1 1 0
0 0 0 0 0 0 0 0 0
0 0 0 0 0 0 0 0 0