3.1
9 9
0 0 0 0 0 0 0 0 0
0 1 1 1 1 1 0 0 0
0 1 1 1 1 1 0 0 0
0 1 4 1 3 1 2 1 0
0 1 1 1 1 1 2 5 0
0 1 MAIN::Sub 1 3 1 2 1 0
0 1 1 1 1 1 0 0 0
0 1 1 1 1 1 0 0 0
0 0 0 0 0 0 0 0 0
0 0 0 0 0 0 0 0 0
0 1 1 1 1 1 0 0 0
0 1 1 1 1 1 0 0 0
0 1 1 1 1 1 2 1 0
0 1 1 1 1 1 2 5 0
0 1 1 1 1 1 2 1 0
0 1 1 1 1 1 0 0 0
0 1 1 1 1 1 0 0 0
0 0 0 0 0 0 0 0 0
Sub
4 4
0 1 1 0
1 1 1 1
1 1 1 1
0 1 1 0
0 1 1 0
1 1 1 1
1 1 1 1
0 1 1 0