3.2
11 11
0 0 0 0 0 0 0 0 0 0 0
0 0 0 0 0 0 0 0 0 0 0
0 0 0 0 0 0 0 0 0 0 0
0 2 1 1 0 0 1 1 4 1 0
0 0 0 1 5 0 1 3 1 1 0
0 0 0 1 1 0 1 Sub_Map_0 Sub_Map_1 1 0
0 0 0 1 1 0 1 1 1 1 0
0 0 0 1 1 1 1 1 1 1 0
0 0 0 1 0 0 0 0 0 0 0
0 0 0 0 0 0 0 0 0 0 0
0 0 0 0 0 0 0 0 0 0 0
0 0 0 0 0 0 0 0 0 0 0
0 0 0 0 0 0 0 0 0 0 0
0 0 0 0 0 0 0 0 0 0 0
0 2 1 1 0 0 1 1 1 1 0
0 0 0 1 5 0 1 1 1 1 0
0 0 0 1 1 0 1 1 1 1 0
0 0 0 1 1 0 1 1 1 1 0
0 0 0 1 1 1 1 1 1 1 0
0 0 0 1 0 0 0 0 0 0 0
0 0 0 0 0 0 0 0 0 0 0
0 0 0 0 0 0 0 0 0 0 0
Sub_Map_0
5 5
1 1 1 1 0
1 1 1 1 0
1 1 1 1 0
1 1 1 1 0
1 1 1 1 0
1 1 1 1 0
1 1 1 1 0
1 1 1 1 0
1 1 1 1 0
1 1 1 1 0
Sub_Map_1
5 5
0 1 1 1 1
0 1 1 1 1
0 1 1 1 1
0 1 1 1 1
0 1 1 1 1
0 1 1 1 1
0 1 1 1 1
0 1 1 1 1
0 1 1 1 1
0 1 1 1 1