3.4
9 9
0 0 0 0 0 0 0 0 0
0 0 0 1 0 0 0 0 0
0 0 1 1 1 Sub 1 0 0
0 0 0 1 1 1 1 1 0
1 1 0 1 3.4 1 4 1 0
0 1 1 1 1 1 1 1 0
0 1 1 1 2 1 2 1 0
0 1 1 1 1 1 1 5 0
0 0 0 0 0 0 0 0 0
0 0 0 0 0 0 0 0 0
0 0 0 1 0 0 0 0 0
0 0 1 1 1 1 1 0 0
0 0 0 1 1 1 1 1 0
1 1 0 1 1 1 1 1 0
0 1 1 1 1 1 1 1 0
0 1 1 1 2 1 2 1 0
0 1 1 1 1 1 1 5 0
0 0 0 0 0 0 0 0 0
Sub
3 3
1 1 1
1 1 1
1 1 1
1 1 1
1 1 1
1 1 1