4.1
7 7
0 0 0 0 0 0 0
0 1 4 1 Sub_Map_0 0 0
0 1 1 1 1 0 0
0 1 MAIN::Sub_Map_0 1 1 0 0
0 1 1 1 2 0 0
0 1 1 1 0 0 0
0 0 0 0 0 0 0
0 0 0 0 0 0 0
0 1 1 1 1 0 0
0 1 1 1 1 0 0
0 1 1 1 1 0 0
0 1 1 1 2 0 0
0 1 1 1 0 0 0
0 0 0 0 0 0 0
Sub_Map_0
7 7
0 0 0 0 0 0 0
0 2 1 1 1 1 0
0 5 0 1 1 1 0
0 0 0 1 1 1 0
0 1 1 1 1 1 0
0 1 1 1 3 1 0
0 0 0 1 0 0 0
0 0 0 0 0 0 0
0 2 1 1 1 1 0
0 5 0 1 1 1 0
0 0 0 1 1 1 0
0 1 1 1 1 1 0
0 1 1 1 1 1 0
0 0 0 1 0 0 0