4.3
9 9
0 0 0 0 0 0 0 0 0
0 1 1 1 1 1 1 1 0
0 1 1 1 1 1 1 1 0
0 1 1 1 1 1 1 1 0
0 4.3 Sub_Map_0 0 1 1 1 1 1
0 1 1 1 1 4 1 1 0
0 1 2 3 1 1 1 1 0
0 1 1 1 1 1 1 1 0
0 0 0 0 0 0 0 0 0
0 0 0 0 0 0 0 0 0
0 1 1 1 1 1 1 1 0
0 1 1 1 1 1 1 1 0
0 1 1 1 1 1 1 1 0
0 1 1 1 1 1 1 1 1
0 1 1 1 1 1 1 1 0
0 1 2 1 1 1 1 1 0
0 1 1 1 1 1 1 1 0
0 0 0 0 0 0 0 0 0
Sub_Map_0
5 5
0 0 0 0 0
0 1 1 1 0
1 1 5 1 0
0 1 1 1 0
0 0 0 0 0
0 0 0 0 0
0 1 1 1 0
1 1 5 1 0
0 1 1 1 0
0 0 0 0 0
