test1
15 15
0 0 0 0 0 0 0 0 0 0 0 0 0 0 0 
0 1 1 1 1 1 1 1 1 1 1 1 1 1 0 
0 1 Sub_Map_1 1 1 1 1 1 2 1 1 1 1 1 0 
0 1 0 1 0 1 1 1 1 1 1 1 1 1 0 
0 1 1 1 1 3 1 1 1 1 1 1 1 1 0 
0 1 1 0 1 1 1 4 0 1 0 1 1 1 0 
0 1 1 1 1 1 1 1 1 1 1 1 1 1 0 
0 1 1 1 0 1 1 1 1 1 1 1 1 1 0 
0 1 1 0 1 1 1 1 0 1 0 1 1 1 0 
0 1 1 1 1 1 0 1 1 1 1 1 1 1 0 
0 1 1 1 1 1 1 1 1 1 1 1 1 1 0 
0 1 1 1 1 1 1 1 1 1 1 1 1 1 0 
0 1 0 1 0 1 1 1 1 1 1 1 0 1 0 
0 1 1 1 1 1 1 1 1 1 1 1 1 1 0 
0 0 0 0 0 0 0 0 0 0 0 0 0 0 0 
Sub_Map_1
8 8
0 0 0 0 0 0 0 0 
0 1 1 1 1 1 1 0 
0 1 1 1 1 1 1 0 
0 1 0 1 0 0 1 0 
1 1 4 1 1 1 1 0 
0 1 1 1 3 2 1 0 
0 1 1 1 1 1 1 0 
0 0 0 0 0 0 0 0 

