test3
15 15
0 0 0 0 0 0 0 0 0 0 0 0 0 0 0 
0 1 1 1 1 1 1 1 1 1 1 1 1 1 0 
0 1 1 1 1 1 1 1 2 1 1 1 1 1 0 
0 1 0 1 0 1 1 1 1 1 1 1 1 1 0 
0 1 1 1 1 3 1 1 1 1 1 1 1 1 0 
0 1 1 0 1 1 1 4 0 1 0 1 1 1 0 
0 1 1 1 1 1 1 1 1 1 1 1 1 1 0 
0 1 1 1 0 1 1 Sub_Map_0 1 1 1 1 1 1 0 
0 1 1 0 1 1 1 1 0 1 0 1 1 1 0 
0 1 1 1 1 1 0 1 1 1 1 1 1 1 0 
0 1 1 1 1 1 1 1 1 1 1 1 1 1 0 
0 1 1 1 1 1 1 1 1 1 1 1 1 1 0 
0 1 0 1 0 1 1 1 1 1 1 1 0 1 0 
0 1 1 1 1 1 1 1 1 1 1 1 1 1 0 
0 0 0 0 0 0 0 0 0 0 0 0 0 0 0 
0 0 0 0 0 0 0 0 0 0 0 0 0 0 0 
0 1 1 1 1 1 1 1 1 1 1 1 1 1 0 
0 1 6 1 1 1 1 1 2 1 1 1 1 1 0 
0 1 0 1 0 1 1 1 1 1 1 1 1 1 0 
0 1 1 1 1 1 1 1 1 1 1 1 1 1 0 
0 1 1 0 1 1 1 1 0 1 0 1 1 1 0 
0 1 1 1 1 1 1 1 1 1 1 1 1 1 0 
0 1 1 1 0 1 1 1 1 1 1 1 1 1 0 
0 1 1 0 1 1 1 1 0 1 0 1 1 1 0 
0 1 1 1 1 1 0 1 1 1 1 1 1 1 0 
0 1 1 1 1 1 1 1 1 1 1 1 1 1 0 
0 1 1 1 1 1 1 1 1 1 1 1 1 1 0 
0 1 0 1 0 1 1 1 1 1 1 1 0 1 0 
0 1 1 1 1 1 1 1 1 1 1 1 1 1 0 
0 0 0 0 0 0 0 0 0 0 0 0 0 0 0 
Sub_Map_0
8 8
0 0 0 0 0 0 0 0 
0 1 1 1 1 1 1 0 
0 1 1 1 1 1 1 0 
0 1 0 1 0 0 1 0 
1 1 1 1 1 1 1 0 
0 1 1 1 3 2 1 0 
0 1 1 1 1 1 1 0 
0 0 0 0 0 0 0 0 
0 0 0 0 0 0 0 0 
0 1 1 1 1 1 1 0 
0 1 1 1 1 1 1 0 
0 1 0 1 0 0 1 0 
1 1 1 1 1 1 1 0 
0 1 1 1 1 2 1 0 
0 1 1 1 1 1 1 0 
0 0 0 0 0 0 0 0 
