test3
9 9
0 0 0 0 0 0 0 0 0 
0 0 0 1 0 0 0 0 0 
0 0 1 1 1 Sub 1 0 0 
0 0 0 1 1 1 1 1 0 
1 1 0 1 1 1 1 1 0 
0 1 1 1 test3 4 1 1 0 
0 1 1 1 2 1 2 1 0 
0 1 1 1 1 1 1 5 0 
0 0 0 0 0 0 0 0 0 
0 0 0 0 0 0 0 0 0 
0 0 0 1 0 0 0 0 0 
0 0 1 1 1 1 1 0 0 
0 0 0 1 1 1 1 1 0 
1 1 0 1 1 1 1 1 0 
0 1 1 1 1 1 1 1 0 
0 1 1 1 2 1 2 1 0 
0 1 1 1 1 1 1 5 0 
0 0 0 0 0 0 0 0 0 
